##########
..#####...
....##....
..........
..........
..........
....#.....
..####....
.######...
##########